[
  {
    "key": "male",
    "title": "열람실",
    "chairs": [
      [0,0,0,0,0,0,0,0,0,0,0,0],
      [0,32,31,30,29,0,0,33,34,35,36,0],
      [0,25,26,27,28,0,0,40,39,38,37,0],
      [0,0,0,0,0,0,0,0,0,0,0,0],
      [0,24,23,22,21,0,0,41,42,43,44,0],
      [0,17,18,19,20,0,0,48,47,46,45,0],
      [0,0,0,0,0,0,0,0,0,0,0,0],
      [0,16,15,14,13,0,0,49,50,51,52,0],
      [0,9,10,11,12,0,0,56,55,54,53,0],
      [0,0,0,0,0,0,0,0,0,0,0,0],
      [0,8,7,6,5,0,0,57,58,59,60,0],
      [0,1,2,3,4,0,0,64,63,62,61,0],
      [0,0,0,0,0,-1,-1,0,0,0,0,0]
    ]
  }
]