[
  {
    "key": "male",
    "title": "남자층(3층)",
    "chairs": [
      [0,38,33,0,32,29,0,28,23,0,22,11,0,10,1,0],
      [0,37,34,0,31,30,0,27,24,0,21,12,0,9,2,0],
      [0,36,35,0,0,0,0,26,25,0,20,13,0,0,0,0],
      [0,0,0,0,0,0,0,0,0,0,0,0,0,0,0,0],
      [0,0,0,0,0,0,0,0,0,0,19,14,0,8,3,0],
      [0,0,0,0,0,0,0,0,0,0,18,15,0,7,4,0],
      [0,0,0,0,-1,-1,0,0,0,0,17,16,0,6,5,0]
    ]
  },
  {
    "key": "female",
    "title": "여자층(2층)",
    "chairs": [
      [0,40,35,0,34,31,0,30,25,0,24,13,0,12,1,0],
      [0,39,36,0,33,32,0,29,26,0,23,14,0,11,2,0],
      [0,38,37,0,0,0,0,28,27,0,22,15,0,10,3,0],
      [0,0,0,0,0,0,0,0,0,0,0,0,0,0,0,0],
      [0,0,0,0,0,0,0,0,0,0,21,16,0,9,4,0],
      [0,0,0,0,0,0,0,0,0,0,20,17,0,8,5,0],
      [0,0,0,0,-1,-1,0,0,0,0,19,18,0,7,6,0]
    ]
  }
]